SIZE 16 16 28 30
map_tiles.png
1 1 1 1 1 1 1 1 1 1 1 1 1 1 1 1 1 1 1 1 1 1 1 1 1 1 1 1 
1 3 3 3 3 3 3 3 3 3 3 3 3 1 1 3 3 3 3 3 3 3 3 3 3 3 3 1 
1 3 1 1 1 1 3 1 1 1 1 1 3 1 1 3 1 1 1 1 3 1 1 1 1 1 3 1 
1 4 1 1 1 1 3 1 1 1 1 1 3 1 1 3 1 1 1 1 3 1 1 1 1 1 4 1 
1 3 1 1 1 1 3 1 1 1 1 1 3 1 1 3 1 1 1 1 3 1 1 1 1 1 3 1 
1 3 3 3 3 3 3 3 3 3 3 3 3 3 3 3 3 3 3 3 3 3 3 3 3 3 3 1 
1 3 1 1 1 1 3 1 1 3 1 1 1 1 1 1 1 1 3 1 1 3 1 1 1 1 3 1 
1 3 1 1 1 1 3 1 1 3 1 1 1 1 1 1 1 1 3 1 1 3 1 1 1 1 3 1 
1 3 3 3 3 3 3 1 1 3 3 3 3 1 1 3 3 3 3 1 1 3 3 3 3 3 3 1 
1 1 1 1 1 1 3 1 1 1 1 1 0 1 1 0 1 1 1 1 1 3 1 1 1 1 1 1 
0 0 0 0 0 1 3 1 1 1 1 1 0 1 1 0 1 1 1 1 1 3 1 0 0 0 0 0 
0 0 0 0 0 1 3 1 1 0 0 0 0 0 0 0 0 0 0 1 1 3 1 0 0 0 0 0 
0 0 0 0 0 1 3 1 1 0 1 1 1 7 7 1 1 1 0 1 1 3 1 0 0 0 0 0 
1 1 1 1 1 1 3 1 1 0 1 6 6 6 6 6 6 1 0 1 1 3 1 1 1 1 1 1 
5 0 0 0 0 0 3 0 0 0 1 6 6 6 6 6 6 1 0 0 0 3 0 0 0 0 0 5 
1 1 1 1 1 1 3 1 1 0 1 1 1 1 1 1 1 1 0 1 1 3 1 1 1 1 1 1 
0 0 0 0 0 1 3 1 1 0 0 0 0 0 2 0 0 0 0 1 1 3 1 0 0 0 0 0 
0 0 0 0 0 1 3 1 1 0 1 1 1 1 1 1 1 1 0 1 1 3 1 0 0 0 0 0 
0 0 0 0 0 1 3 1 1 0 1 1 1 1 1 1 1 1 0 1 1 3 1 0 0 0 0 0 
1 1 1 1 1 1 3 1 1 0 1 1 1 1 1 1 1 1 0 1 1 3 1 1 1 1 1 1 
1 3 3 3 3 3 3 3 3 3 3 3 3 1 1 3 3 3 3 3 3 3 3 3 3 3 3 1 
1 3 1 1 1 1 3 1 1 1 1 1 3 1 1 3 1 1 1 1 1 3 1 1 1 1 3 1 
1 4 1 1 1 1 3 1 1 1 1 1 3 1 1 3 1 1 1 1 1 3 1 1 1 1 4 1 
1 3 3 3 1 1 3 3 3 3 3 3 3 3 3 3 3 3 3 3 3 3 1 1 3 3 3 1 
1 1 1 3 1 1 3 1 1 3 1 1 1 1 1 1 1 1 3 1 1 3 1 1 3 1 1 1 
1 3 3 3 3 3 3 1 1 3 1 1 1 1 1 1 1 1 3 1 1 3 3 3 3 3 3 1 
1 3 1 1 1 1 1 1 1 3 3 3 3 1 1 3 3 3 3 1 1 1 1 1 1 1 3 1 
1 3 1 1 1 1 1 1 1 1 1 1 3 1 1 3 1 1 1 1 1 1 1 1 1 1 3 1 
1 3 3 3 3 3 3 3 3 3 3 3 3 3 3 3 3 3 3 3 3 3 3 3 3 3 3 1 
1 1 1 1 1 1 1 1 1 1 1 1 1 1 1 1 1 1 1 1 1 1 1 1 1 1 1 1 
